%%%%%%%%%%%%%%
%          % %
%          % %
%          % %
%          % %
%          % %
%          % %
%          % %
%     P    % %
%          % %
%          % %
%          % %
%.         % %
%%%%%%%%%%%%%%
