%%%%%%%%%%%%%%%%%%%
%                 %
% % % %%%%%% % %% %
% % % %    % %  % %
% %%% %  %%% %  % %
%.      P    %  % %
%%%%%%%%%%%%%%%%%%%%
