%%%%%%
%    %
% %% %
% %% %
% P  %
% %%%%
%.   %
%%%%%%