%%%%%%%%%%%%%%%%%
%.    % %       %
% %%% % % % %%% %
% %   % %     % %
% % %%% % %%%%% %
% %   %         %
% %%% %%% % %%% %
%P          %   %
%%%%%%%%%%%%%%%%%
