%%%%%%%%%%%%%%%%%%%%%%%%%%%%%%%
% %         %%   %%%%%%    %% %
% % %%%%%%% %%%%%%%     %%%%% %
% %%% %%%%% %%%%%%% %%% % %%% %
%.             P    %         %
%%%%%%%%%%%%%%%%%%%%%%%%%%%%%%%
