%%%%%%%%%%%%%%%%%%%%%%%%%%%%%%%
%            %%%%%            %
%%% %   %%%         % %   % %%%
%   %%% % %%%% % %%%%%% %%%   %
% %     %      %      %     % %
% %%% %%%%% %%%%%%% %%% % %%%%%
%.    %        P    %   %     %
%%%%%%%%%%%%%%%%%%%%%%%%%%%%%%%
