%%%%%%%%%
% P     % 
% % % %%%  
%.    %%% 
%%%%%%%%%
