%%%%%%%%%%%%%%%%%%%%
%   %         %%   %
% % % %%%%%%%%%% % %
%                  %
%%%%%%%% % %%%%%%%P%
%.                 %
%%%%%%%%%%%%%%%%%%%%
