%%%%%%%%%%%%%%%%%%%%%%%%%
%   P                   %
%                       %
%                       %
%                       %
%                       %
%                       %
%.                      %
%%%%%%%%%%%%%%%%%%%%%%%%%
