%%%%%%%%%%%%%%%%%%%%
%                  %
%                  %
%        P         %
%                  %
%.                 %
%%%%%%%%%%%%%%%%%%%%
