%%%%%%%%%%%%%%%%%%%%
%      %    %      %
%  %   %%  %%   %  %
% %  %        %  % %
%  % % %%%%%% % %  %
%.       P         %
%%%%%%%%%%%%%%%%%%%%
