%%%%%%%%%
%   %   %
%%% %%%%%
%      P%
%%%%%%% %
%       %
% %%%%% %
%     % %
%%%%% % %
%     % %
% %%%%%%%
%       %
%%%%%%% %
%.      %
%%%%%%%%%
