%%%%%%%%%%%%%%%%%%%%
%               P  %
% %% %% %% %% %% % %
%.%% %           % %
%%%%%%%%%%%%%%%%%%%%
