%%%%%%%%%%%%%%%%%%%%
%      %    %      %
% %%   %%  %%   %% %
% %  %        %  % %
% %% % %%%%%% % %% %
%.       P         %
%%%%%%%%%%%%%%%%%%%%
