%%%%%
% P %
%%% %
%.  %
%%%%%
