%%%%%%%%%
%   %   %
%%%%%%% %
%P      %
% %% %% %
%.%%    %
%%%%%%%%%
