%%%%%%%%
%      %
%   P  %
% %%%% %
% %    %
% % %%%%
%.%    %
%%%%%%%%
