%%%%%%%%%
%       %
%%%% %% %
%   P   %
% %% %% %
%.%     %
%%%%%%%%%
