%%%%%%%%
%   P  %
% %%%%%%
%.     %
%%%%%%%%
