%%%%%%%%%%%%%%%%%%%%
%    %        %    %
% %% % %%  %% % %% %
% %     %  %     % %
% % %% %%  %% %% % %
%           % %    %
% %    %%%%%% %  % %
% %    %    % %  % %
% %    % %%%% %  % %
% %           %  % %
% %% % %%%%%% % %% %
%.   %   P    %    %
%%%%%%%%%%%%%%%%%%%%
